What Lovers Do - Maroon 5 / SZA
I'm Not Mad - Halsey
阿里里(葫芦丝) - 民乐
白桦林 - 朴树
담다디 (대상) - 李尚恩
Last Dance - 伍佰 & China Blue
告白之夜 (纯音乐) - CMJ
年华似水 - 黄磊
多想在平庸的生活拥抱你 - 隔壁老樊
我曾 - 隔壁老樊
Lemon - 米津玄師
Weightless - Marconi Union
胆小鬼 - 郭狗剩
黎明前的黑暗 (完整版) - Bater official / Bater Offical
出山 - 花粥 / 王胜娚
TOHRU - James Shimoji
农夫渔夫 - 大乔小乔
秋酿 - 房东的猫
纸飞机快飞吧 - 周跳跳（沐萱） / 二二星 / 马加加
Hand Covers Bruise - Trent Reznor / Atticus Ross
Panama - Matteo
演员 - 王春燕
交作业 - 左小祖咒 / 朱婧汐Akini Jing
人生有限公司 - 五月天
你还要我怎样 - 薛之谦
Darlin' - The Beach Boys
唱那未完的歌 - 任静静
祈求(不插电) - 任静静
Schnappi - Joy Gruttmann
只要和你走下去 - 孙楠 / 谭维维
普通DISCO - 三无MarBlue
普通DISCO - ilem / 洛天依 / 言和
